10
20
11111111111111111111
10000000000000000001
10500000000000000001
10000000000000000001
10000000000000000001
10000000000000000001
10000000000000000101
10000000000000000201
10000000000000000001
11111111111111111111
