10
20
11111111111111111111
10000000000000000001
10500000000100000001
10010000000000000001
10000000004000000001
10000000000000111111
10000000000410010001
10201000000000010201
10000000000000000001
11111111111111111111
