10
20
11111111111111111111
10000000000000000031
10500000000000000001
10000000000000000001
10000000004000000001
10000000000000111111
10000000000000010001
10200000000000010201
10000000000000000001
11111111111111111111