5
10
1111111111
1000000001
1020000001
1000000001
1111111111