10
20
11111111111111111111
10000000000000000031
10200000000000000001
10000000000000000001
10000000004000000001
10000000000000000001
10000000000000000001
10200000000000000001
10000000000000000001
11111111111111111111