10
20
11111111111111111111
10000404404440000041
10104010440044400001
10104010104000440001
10404004000000444001
10104444100000004401
10101014410000000401
10000000000444444401
10044444444000000001
11111111111111111111
