10
20
11111111111111111111
10001212100000000001
10201010101101010201
10001010041001111111
10111000111140000011
14000010041001111011
11111011100001210001
12101010001111010201
10000000100000010001
11111111111111111111
