10
20
11111111111111111111
10002100000000000001
10111171111101012101
10000000021201111111
10111010511140000001
14060010041001111011
10111011100001210001
11101410001111010101
12000000100000810201
11111111111111111111
