10
20
11111111111111111111
10000000000001000001
10110100000001000001
10100100506001000001
10100111111111000001
10100000000000000001
10100011111001000001
10111110001111000001
10000000100000000001
11111111111111111111
