10
20
11111111111111111111
10001212100000000001
10200030001101010201
10005000041001111111
10111000011140000011
14000010041001181011
11111011100001210001
12101010001111010201
10006000100070010001
11111111111111111111
