10
20
11111111111111111111
16000000000000000001
11111111111111111001
12000000000000001121
11101010101011100001
10001010101000111111
11111000000010000021
10000111111111111101
12000000000000000001
11111111111111111111
