10
20
11111111111111111111
10000000000000000001
10000000000000000001
16000000000000000001
10000000000000000001
10000000000000000001
10000000000000000001
10000000000000000001
10200000020000000001
11111111111111111111
