10
20
11111111111111111111
10000000000000000001
11111111111111111001
16000000000000001101
11101010101011100001
10001010101000111111
11111000000010000001
10000111111111111101
10200000020000000001
11111111111111111111
