10
20
11111111111111111111
16000000000000000001
11111111111111111001
12000000000000001101
11101010101011100021
10001010101000111111
11111000000010000001
10000111111111111101
12000002020000200021
11111111111111111111
