10
20
11111111111111111111
10000000000000000101
10101011111101110101
10101010000101000101
10101010160101011101
10101010111101000001
10101010000000011101
10101000111111110001
10121010000000000101
11111111111111111111
